16:10
################
################
0$$1############
###$############
###$#####4$$$$$9
###$#####$######
###$#####$######
###2$$$$$3######
################
################